XXXXXXXXXXXXXXX
XOOOXXXXXOOOXXX
XXXSOOOOOOXXXXX
XXXXOXXXXOXXXXX
XXXXOXXXXOOOOXX
XOOOOXXXXOXXXXX
XXOXOOOOOOXXXXX
XXOXOXXXXOXXXXX
XXOXOXXXXOXXXXX
XXOXOXXOOOOOXXX
XOOOOOOOXXXOXXX
XXOXXXXOXXXOXXX
XXOXXXXOOOOOOXX
XXOOOOOOXXXXOEX
XXXXXXXXXXXXXXX