XXXXXXXX
XOOOOOOX
XOXXXXEX
XXOOOOOX
XOOOXXOX
XOXOOOOX
XSXOXOXX
XXXXXXXX