XXXXXXXXXXXXXXXXXXXXXXXXXXXXXX
XXXXXXXXXXXXXXXXXXXXXOOOOOOOOX
XXXOOOSOOOOOOOOOXXXXXOXXXXXXOX
XXXOXXXXXXXXOXXXXOOOOOOOOOOOOX
XXXOXXXXXXXXOXXXXXXXXOXXXXXOXX
XXXOOOOOOOOOOXXXXXXXXOXXXXXOXX
XOOOXXOXXOXXOXXXXXXXXOXXXXXOXX
XOXXXXOXXOXXOOOOOOOOOOOOOOOOOX
XOOOXXOXXOXXXXXXXOXXXXXXXXXXOX
XXXOXXOXXOXXXXXXXOXXXXXXOOOOOX
XXXOXXOXXOXXXXXXXOXXXXXXOXXXXX
XXXOOOOXXOXXXXXXXOXXXXXXOXXXXX
XXXOXXOXXOXXOOOOOOOOOOOOOOOXXX
XOOOXXOXXOXXXXXXXOXXXXOXXXOXXX
XOXXXXXXXOXXXXXXXOXXXXOXXXOOOX
XOOOOOOXXOXOOOOOOOOXXXOXXXXOXX
XXXXXXOXXOXOXXXXXXOXXXOXXXXOOX
XOEXXXOXOOOOOOOOXXOOOOOOOOOXOX
XOXXXXOXXXXOXXXXXXOXXXXXOXOOOX
XOOXXXOXXXXOXXXOOOOXXXXXOOOXXX
XXOXXXOOOOOOOOOOXXXXXXXXXXOXXX
XXOOOXXXOXXXOXXXXXXXXXXXXOOOXX
XXOXOXXXOXXXOXXXXXXXXXXXXXXOXX
XOOOOXXXOXXXOXXXXXXXOOOOOOOOXX
XOXXXXXXOOOOOXXXXXXXOXXXOXXXXX
XOXXXXXXXXXXOXXXXXXXOXXXOXXXXX
XOOOOXXXXXXXOXXXXXXXOXXXXXXXXX
XOXXOXXXOOOOOOOOOOOOOOOOXXXXXX
XOXXOOOOOXXXXXXXXXXXXXXXXXXXXX
XXXXXXXXXXXXXXXXXXXXXXXXXXXXXX